ABSOLUTIZING: LAZING + SUBITO
ACCLIMATIZED: AMAZED + CLITIC
ADAPTATIONAL: APODAL + ATTAIN
ADJUDICATING: ADDUCT + GAIJIN
ADOPTABILITY: PAYOLA + TIDBIT
ADVISABILITY: AVIDLY + TIBIAS
AEROBICIZING: BRAIZE + CONGII
AFORETHOUGHT: HOOFER + TAUGHT
ALLOGRAFTING: FLORAL + GATING
ALPHABETIZED: ABLAZE + PITHED
ANAEROBIOSES: ARIOSE + BEANOS
ANAESTHETIZE: ATTAIN + HEEZES
ANAPHYLACTIC: APICAL + CHANTY
ANGIOGRAPHIC: AGARIC + HOPING
ANKYLOSAURUS: RYOKAN + USUALS
ANNEXATIONAL: AXONAL + INNATE
ANTIAIRCRAFT: ANTIAR + FRACTI
ANTICIPATION: ATTAIN + PIONIC
ANTIDILUTION: INTUIT + LADINO
ANTIFRICTION: IRITIC + NONFAT
ANTIMOSQUITO: MANITO + QUOITS
ANTINAUSEANT: SUNTAN + TAENIA
ANTIPRURITIC: IATRIC + TURNIP
AORTOGRAPHIC: AARRGH + OCTOPI
APPETIZINGLY: GLITZY + NAPPIE
APPOGGIATURA: AGOUTI + GRAPPA
APPROBATIONS: PAPAIN + ROBOTS
APPROPRIABLE: ARRIBA + POPPLE
AQUATINTISTS: SQUATS + TITIAN
ARBORIZATION: ANTIAR + BORZOI
ARCHIPELAGIC: CAGIER + CALIPH
ARTIFICIALLY: FAIRLY + ITALIC
ASSIMILATIVE: LAMIAE + VISITS
ASTIGMATISMS: MAISTS + STIGMA
ASTROBIOLOGY: GORILY + TABOOS
ASYMPTOMATIC: MYOMAS + TIPCAT
ATOMIZATIONS: AMAZON + OTITIS
AUDIOLOGICAL: ADAGIO + LOCULI
AUDIOVISUALS: AUDIOS + VISUAL
AUGMENTATIVE: AVIATE + NUTMEG
AUTOECIOUSLY: COYAUS + OUTLIE
AUXOTROPHIES: HOAXER + PISTOU
AVARICIOUSLY: AVIARY + COULIS
AVICULTURIST: CULTUS + TRIVIA
AVITAMINOSIS: AVISOS + INTIMA
AZOTOBACTERS: BEZOAR + COTTAS
BACKBREAKING: BACKER + BAKING
BACKSHEESHES: BASHES + CHEEKS
BACKSTABBERS: BRACTS + KEBABS
BACKSWIMMERS: SMIRKS + WEBCAM
BARBARICALLY: BARBAL + RACILY
BEAUTYBUSHES: BEAUTY + BUSHES
BECUDGELLING: CUBING + GELLED
BEHAVIOURISM: HAVIOR + IMBUES
BELITTLEMENT: METTLE + NIBLET
BENCHMARKING: EMBANK + GRINCH
BENEFICENTLY: FEEBLY + INCENT
BENZALDEHYDE: BENZYL + HEADED
BEWITCHINGLY: BLIGHT + WINCEY
BIBLIOPHILES: BILLIE + BISHOP
BILINGUALITY: LUNGYI + TIBIAL
BIOACOUSTICS: COBIAS + COITUS
BIOAVAILABLE: BAILIE + LAVABO
BIOPHYSICIST: BIOTIC + PHYSIS
BIUNIQUENESS: BISQUE + ENNUIS
BLACKLISTING: BLACKS + TILING
BLACKMAILING: CALKIN + GIMBAL
BLADDERWORTS: DEBTOR + DRAWLS
BLIMPISHNESS: BLIMPS + SHINES
BLOCKBUSTING: BLOCKS + TUBING
BLOWTORCHING: BLOTCH + ROWING
BLUNDERINGLY: DUNNER + GLIBLY
BOBSLEIGHING: GIBBON + SLEIGH
BODHISATTVAS: BATHOS + DAVITS
BODYBUILDING: BIDING + DOUBLY
BODYGUARDING: BOUDIN + DRAGGY
BRAGGADOCIOS: CORGIS + DAGOBA
BREAKTHROUGH: BARKER + THOUGH
BRILLIANTINE: ANILIN + RIBLET
BRONCHOSCOPY: BRONCO + PSYCHO
BURGLARIZING: BRAZIL + URGING
BUTTONHOLING: BUTTON + HOLING
BUTTONHOOKED: BUTTON + HOOKED
CABBAGEWORMS: COBWEB + GRAMAS
CALCULATEDLY: CULLAY + TALCED
CALLIGRAPHIC: CALIPH + GARLIC
CARDIOGRAPHY: GAYDAR + ORPHIC
CARILLONNING: COLLAR + INNING
CATABOLIZING: AZOTIC + BALING
CHANNELIZING: LIGNAN + ZECHIN
CHECKERBERRY: CHERRY + REBECK
CHILDPROOFED: FOLDED + ORPHIC
CHITCHATTING: CITING + THATCH
CHLORENCHYMA: CRANCH + HOMELY
CHLOROPHYLLS: PHYLLO + SCHORL
CHOROGRAPHER: CHARRO + GOPHER
CHROMATOGRAM: COHORT + GRAMMA
CHROMOPHOBES: BROCHE + OOMPHS
CHRONOGRAPHS: CHARRS + GONOPH
CHUBBINESSES: CUBEBS + SHINES
CINEMATIZING: INCITE + MAZING
CIRCUITOUSLY: CRUISY + TOLUIC
CIRCULARIZES: CIRCUS + LAZIER
CIRCUMCISERS: CIRCUS + CRIMES
CIRCUMFLUENT: CULTIC + FRENUM
CIRCUMFUSING: CIRCUS + FUMING
CIRCUMSCRIBE: CRISIC + CUMBER
CIVILIANIZES: CLIVIA + SEIZIN
CIVILISATION: ITALIC + VISION
CLASSICALITY: CLASSY + ITALIC
CLASSICISING: SICCAN + SIGILS
CLASSICISTIC: CASSIS + CLITIC
CLIMATICALLY: CALMLY + ITALIC
CLIQUISHNESS: CLINES + SQUISH
CLOWNISHNESS: CLOWNS + SHINES
CODICOLOGIES: COLICS + GOODIE
COLLEGIALITY: ATELIC + LOGILY
COLLEGIATELY: CITOLE + GALLEY
COLLEMBOLANS: BALLON + CELOMS
COLLEMBOLOUS: BLOOMS + LOCULE
COLORIMETRIC: CLITIC + ROOMER
COMEUPPANCES: COUPES + ENCAMP
COMMEMORATED: DOCTOR + MAMMEE
COMMODIOUSLY: CLOUDY + SIMOOM
COMMONWEALTH: COMMON + WEALTH
COMPLEXIFIES: EXPOSE + FILMIC
COMPORTMENTS: COMPTS + MENTOR
COMPULSIVITY: PICULS + VOMITY
COMPUNCTIONS: COMPTS + NUNCIO
COMPUTERIZED: COZIER + TUMPED
CONCEPTUALLY: CANOPY + CULLET
CONCOMITANCE: ACETIC + NONCOM
CONCORDANTLY: CONNOR + DACTYL
CONCUPISCENT: COCCUS + TENPIN
CONDESCENDED: CODECS + DENNED
CONSEQUENCES: QUEENS + SCONCE
CONSIGNMENTS: MIGNON + SCENTS
CONSTRINGING: CONING + STRING
CONSTRUCTORS: CROTON + CRUSTS
CONTINGENCES: CONGES + INCENT
CONTRAPUNTAL: CANTAL + UPTORN
CONVENTUALLY: AUNTLY + CLOVEN
CONVEYANCING: CANING + CONVEY
CONVIVIALITY: CAVITY + VIOLIN
CONVOLUTIONS: NUNCIO + VOLOST
CONVULSIVELY: CONVEY + VILLUS
COPOLYMERIZE: COZIER + EMPLOY
COPROPHILIAC: HOOPLA + PICRIC
COPROPHILOUS: COLOUR + HIPPOS
CORONOGRAPHS: CHARRO + PONGOS
COSMOLOGICAL: CALICO + GLOOMS
COUNCILMANIC: ACINIC + COLUMN
COUNCILWOMEN: COWMEN + UNCOIL
COUNTERCHECK: ETCHER + UNCOCK
COUNTERPOWER: CONURE + POWTER
COUNTERWORLD: CROWER + UNTOLD
CRACKERJACKS: CRACKS + JACKER
CRIMINALIZES: LIMNIC + ZAIRES
CRITICIZABLE: BRAIZE + CLITIC
CROWDFUNDING: DROWND + FUNGIC
CRYPTOCOCCAL: COCCAL + CRYPTO
CRYPTOCOCCUS: COCCUS + CRYPTO
CRYPTOGRAPHS: CRYPTO + GRAPHS
CRYPTOSYSTEM: CRYPTO + SYSTEM
CRYSTALIZING: CAIRNS + GLITZY
CRYSTALLIZED: CRAZED + STILLY
CULTIVATIONS: INTUIT + VOCALS
CUMULATIVELY: ACUITY + VELLUM
CYBERSURFERS: CUBERS + FRYERS
CYCADOPHYTES: DECOYS + PATCHY
CYCLODEXTRIN: CYCLIN + DEXTRO
CYCLOGENESES: CONGES + LYCEES
CYTOGENETICS: CESTOI + CYGNET
DEACIDIFYING: CADDIE + IGNIFY
DEFICIENCIES: DEIFIC + NIECES
DEFINITIVELY: ENDITE + VILIFY
DELIGHTFULLY: FILTHY + GULLED
DEMILITARIZE: LAZIED + MITIER
DESTIGMATIZE: GITTED + MAIZES
DEXTROROTARY: DEXTRO + ROTARY
DIABOLICALLY: BODILY + LAICAL
DIAMONDBACKS: CABMAN + KIDDOS
DIBENZOFURAN: BRAIZE + UNFOND
DICHOTICALLY: CHILLY + DACOIT
DIDACTICISMS: ACIDIC + MIDSTS
DIFFUSIONISM: OIDIUM + SNIFFS
DILATABILITY: DAYLIT + TIBIAL
DILATATIONAL: ALODIA + LATTIN
DILLYDALLIES: ALLIED + IDYLLS
DISAFFILIATE: AALIIS + TIFFED
DISBANDMENTS: BANNED + MIDSTS
DISCOMMODING: COSMID + DOMING
DISDAINFULLY: FIDDLY + INSULA
DISINCLINING: DICING + LININS
DISJOINTEDLY: DILDOS + JITNEY
DISSUASIVELY: AVIDLY + ISSUES
DISTINCTIONS: IODINS + TINCTS
DISTRIBUTARY: TURBIT + YAIRDS
DISUNIONISTS: IODINS + SUINTS
DIVISIONISTS: IODINS + VISITS
DODECAPHONIC: CADDIE + PONCHO
DOXYCYCLINES: CYCLIN + DESOXY
DRAUGHTBOARD: DARBAR + DOUGHT
DRIVEABILITY: TIDIER + VIABLY
ECLECTICALLY: CALLET + CICELY
ECOFEMINISMS: FEMMES + IONICS
EFFEMINACIES: EFFACE + IMINES
EFFERVESCENT: EFFECT + NERVES
EMBLAZONMENT: BENZAL + MOMENT
EMBLEMATIZES: BEZELS + TAMMIE
ENCHANTMENTS: MENSCH + TENANT
ENCUMBRANCES: BUSMEN + CANCER
ENDOPEROXIDE: EXPEND + OROIDE
ENSANGUINING: ENSIGN + GUANIN
ENTRANCEMENT: CEMENT + TANNER
ENVELOPMENTS: PENMEN + VOLTES
ENZYMOLOGIST: GIMLET + SNOOZY
EPEXEGETICAL: EXCITE + PELAGE
EPICUTICULAR: CUPULE + IATRIC
EPIPHENOMENA: IMPONE + PEAHEN
EQUABILITIES: BAILIE + QUIETS
EQUIPROBABLE: LIBBER + OPAQUE
EQUITABILITY: EQUITY + TIBIAL
EQUIVALENTLY: QUINTE + VALLEY
EQUIVOCATING: CAIQUE + VOTING
ERYTHROCYTIC: OCHERY + YTTRIC
ESPIEGLERIES: GLISSE + PEERIE
ESTHETICIZES: SEIZES + THETIC
ETHYLBENZENE: BENZYL + ETHENE
EVANESCENCES: ACCESS + VENENE
EVERYDAYNESS: SAYEDS + VENERY
EXACERBATING: BINGER + EXACTA
EXCOGITATING: EXOTIC + GATING
EXCRESCENTLY: CYCLES + EXTERN
EXFOLIATIONS: FIXATE + SOLION
EXOTHERMALLY: EXHORT + LAMELY
EXPATRIATION: ATTAIN + POXIER
EXPLOITATION: OXTAIL + POINTE
EXTEMPORIZED: DOZIER + EXEMPT
EXTEMPORIZES: EXEMPT + SEIZOR
EXTENDEDNESS: EXTEND + SENSED
EXTINGUISHER: HEXING + SUITER
EXTORTIONARY: ROTARY + TOXINE
EXTRACTIVELY: CERVIX + LYTTAE
EXTRAPOLATOR: AORTAL + EXPORT
EXTRAVAGANCE: EXACTA + GRAVEN
EYEWITNESSES: SEISES + TWEENY
FACILITATIVE: FETIAL + VIATIC
FANATICIZING: NIACIN + ZAFTIG
FEMININITIES: FINITE + IMINES
FEMINIZATION: FOMITE + ZINNIA
FIBERIZATION: BRAIZE + FINITO
FIBRILLATING: FILING + TRIBAL
FIBRINOLYSIN: FIBRIN + NOSILY
FLABBERGASTS: BABELS + GRAFTS
FLABBINESSES: ABBESS + ELFINS
FLABELLIFORM: FIMBLE + FLORAL
FLAMBOYANTLY: BOTFLY + LAYMAN
FLAMMABILITY: FAMILY + TIMBAL
FLAVIVIRUSES: FIVERS + VISUAL
FLOCCULATING: CULTIC + FLAGON
FLUIDIZATION: DIAZIN + TUFOLI
FLUOROGRAPHY: ORFRAY + PLOUGH
FLUOROSCOPIC: FLOCCI + POROUS
FOLKSINGINGS: FLONGS + SKIING
FOOTFAULTING: FLAGON + OUTFIT
FOOTSLOGGING: GIGLOT + GONOFS
FORGEABILITY: OBLIGE + RATIFY
FORMULARIZER: FRIZER + MORULA
FOUNDATIONAL: ATONIA + UNFOLD
FOUNTAINHEAD: FONDUE + TAHINA
FRATERNIZING: ANTING + FRIZER
FRENCHIFYING: FRENCH + IGNIFY
FRITILLARIAS: FILIAL + RISTRA
FUNAMBULISMS: FANUMS + LIMBUS
FURUNCULOSIS: COUSIN + SULFUR
GADZOOKERIES: EDGIER + KAZOOS
GAMIFICATION: AGAMIC + FINITO
GASIFICATION: CONGII + TAFIAS
GEMMOLOGISTS: MOGGIE + SMOLTS
GENUFLECTING: FUNGIC + GENTLE
GENUFLEXIONS: EXOGEN + SINFUL
GINGIVITISES: GIEING + VISITS
GLASSBLOWERS: GROWLS + SABLES
GLUTETHIMIDE: GITTED + HELIUM
GLUTTONOUSLY: OUTGUN + TOLYLS
GOBBLEDEGOOK: BOGGLE + BOOKED
GOBBLEDYGOOK: BLOGGY + BOOKED
HAEMOPHILIAS: HIEMAL + POISHA
HAGIOLOGICAL: LOCHIA + LOGGIA
HANDBREADTHS: BANDED + THRASH
HANDSTAMPING: MIGHTS + PANDAN
HARMLESSNESS: MESHES + SNARLS
HATCHABILITY: BITCHY + HIATAL
HELIOGRAPHIC: CHALEH + PIROGI
HERITABILITY: BAILIE + THIRTY
HIERARCHIZES: HAZIER + RICHES
HIPPOPOTAMUS: MISHAP + POPOUT
HISTORICIZED: SCHIZO + TIDIER
HOBBLEDEHOYS: HOBBED + HOYLES
HOMEOPATHIES: MAHOES + OPHITE
HOMEOTHERMIC: COMETH + HOMIER
HOMESCHOOLED: ECHOED + SHOLOM
HOMOEOPATHIC: AHCHOO + OPTIME
HOMOTHALLISM: HOMMOS + THALLI
HONEYMOONING: HOMINY + NONEGO
HOPSCOTCHING: HOPING + SCOTCH
HORIZONTALLY: LAZILY + THORON
HOUSEHUSBAND: ABOUND + HUSHES
HUMANIZATION: MAHOUT + ZINNIA
HYDROBIOLOGY: HYBRID + OOLOGY
HYDROCEPHALY: ARCHLY + HYPOED
HYDROLYZATES: HYDRAE + ZLOTYS
HYDROMORPHIC: HYDRIC + MORPHO
HYDROXYUREAS: DESOXY + HURRAY
HYOSCYAMINES: COYISH + YAMENS
HYPERBOLIZES: BREEZY + POLISH
HYPERCHARGED: GHARRY + PECHED
HYPERLIPEMIA: HIRPLE + PYEMIA
HYPERTEXTUAL: PHYLAE + URTEXT
HYPERTHYROID: DITHER + PYROHY
HYPNOTHERAPY: HAPTEN + PYROHY
HYPOCALCEMIC: CHICLY + POMACE
HYPOCYCLOIDS: CYCLOS + HYPOID
HYPOKALEMIAS: HIEMAL + YAPOKS
HYPOSTATIZED: SPOTTY + ZAIDEH
HYPOSTATIZES: PHIZES + TOASTY
IDEALIZATION: IODIZE + LATINA
IDEOLOGIZING: IODIZE + OGLING
IDIOSYNCRASY: ORCINS + SAYYID
IDOLISATIONS: ALOINS + IDIOTS
ILLEGALIZING: GILLIE + LAZING
ILLEGITIMACY: ELICIT + GAMILY
ILLOGICALITY: ITALIC + LOGILY
ILLUSORINESS: ISSEIS + UNROLL
IMMEMORIALLY: MAMMER + OILILY
IMMOBILIZERS: LIMIER + ZOMBIS
IMMUNOASSAYS: MIMOSA + UNSAYS
IMPERATIVELY: IMPALE + VERITY
IMPERCEPTIVE: PEEPER + VICTIM
IMPERCIPIENT: INTIME + PRECIP
IMPERFECTEST: FIERCE + TEMPTS
INCAUTIOUSLY: ACUITY + INSOUL
INCHOATIVELY: CONVEY + LITHIA
INCLEMENCIES: CLINES + ICEMEN
INCOGNIZANCE: NONAGE + ZINCIC
INCOMPETENCE: INCOME + PECTEN
INCOMPETENCY: NOCENT + PYEMIC
INCONTINENCE: CONINE + INCENT
INCONTINENCY: INCENT + INCONY
INCONVENIENT: CONINE + INVENT
INCORPORATOR: RACINO + TORPOR
INDECISIVELY: VISCID + YEELIN
INDEPENDENCE: EDENIC + PENNED
INDIFFERENCY: FENCER + NIDIFY
INDUCIBILITY: INCUBI + TIDILY
INEFFACEABLE: BEFLEA + FIANCE
INEFFICIENTS: NIECES + TIFFIN
INEQUALITIES: LIAISE + QUINTE
INEXPEDIENCE: EXCIDE + PINENE
INEXPEDIENCY: EXCEED + PINYIN
INEXTRICABLY: AXENIC + TRILBY
INFELICITIES: CEILIS + FINITE
INFIBULATION: BIOTIN + INFULA
INFILTRATIVE: FINIAL + TRIVET
INFINITIVELY: INTINE + VILIFY
INFUNDIBULUM: FUMULI + UNBIND
INSTILLMENTS: STILLS + TINMEN
INSTITUTIONS: INIONS + TUTTIS
INTELLECTIVE: EVINCE + LITTLE
INTERIORIZED: DOZIER + TINIER
INTERJECTORY: JITNEY + RECTOR
INVAGINATING: TINING + VAGINA
INVAGINATION: ATONIA + VINING
INVITATIONAL: ATTAIN + VIOLIN
INVULNERABLY: RUNNEL + VIABLY
IRASCIBILITY: BIALYS + IRITIC
IRRADIATIONS: ADROIT + RAISIN
JEOPARDIZING: DOZIER + JAPING
JOURNALIZING: JUNIOR + LAZING
JUDGMENTALLY: JUNGLY + MALTED
JURISTICALLY: JURIST + LACILY
KETOCONAZOLE: KETONE + ZOCALO
KLUTZINESSES: LUTZES + SKEINS
KNEECAPPINGS: CASING + KEPPEN
LABYRINTHIAN: BRANNY + LITHIA
LACTOBACILLI: ABOLLA + CLITIC
LANDLESSNESS: SEDANS + SNELLS
LANDLUBBERLY: LADLER + NUBBLY
LARYNGECTOMY: COMELY + GANTRY
LARYNGOSCOPY: CALORY + SPONGY
LEGITIMIZERS: GIMLET + SIZIER
LEUKOCYTOSES: COOKEY + TUSSLE
LEUKOPOIESES: LOUIES + PEKOES
LEUKOPOIESIS: LOUIES + POKIES
LEUKOPOIETIC: COOKIE + PLUTEI
LEXICALIZING: EXILIC + LAZING
LIBERALIZING: BILLIE + RAZING
LITURGIOLOGY: LOGILY + OUTRIG
LIVERMORIUMS: MILIUM + ROVERS
LOCALIZATION: ITALIC + ZOONAL
LOGISTICALLY: LOGILY + TICALS
LOLLYGAGGING: GALLON + GIGGLY
LYOPHILISING: HOLILY + SIPING
MAGNIFICENCE: FACING + ICEMEN
MAJORITARIAN: ANTIAR + ROMAJI
MAQUILADORAS: AMIDOL + QUASAR
MAXIMISATION: AXIOMS + INTIMA
MECHANIZABLE: BENZAL + HAEMIC
MEMORABILITY: MEMORY + TIBIAL
METABOLIZING: BOLETI + MAZING
MEZZOTINTING: MIZZEN + TOTING
MICROBREWERY: CORYMB + REWIRE
MICROCHIPPED: CHORIC + PIMPED
MICROFIBRILS: FIBRIL + MICROS
MICROSURGERY: CORGIS + MURREY
MICROTUBULAR: BRUTAL + CORIUM
MILLESIMALLY: MALLEI + SLIMLY
MISEMPHASIZE: MAMIES + PHIZES
MISOGYNISTIC: CITING + MYOSIS
MOCKINGBIRDS: BRICKS + DOMING
MOLLYCODDLED: COLDLY + MOLDED
MONETIZATION: MOTION + ZEATIN
MONOCROPPING: CORING + POMPON
MONOGRAMMING: GORING + MAMMON
MONOMANIACAL: AMMINO + CANOLA
MONOPHTHONGS: GONOPH + MONTHS
MONOPOLISTIC: COLONI + IMPOST
MONOPOLIZERS: MINORS + POZOLE
MONUMENTALLY: ANONYM + MULLET
MOTHERFUCKER: FUCKER + MOTHER
MOTHPROOFING: INFORM + PHOTOG
MOTIVATIONAL: LATINA + VOMITO
MULTICOUNTRY: TROTYL + UNICUM
MULTILINGUAL: ALLIUM + LUTING
MULTIMILLION: LINTOL + MILIUM
MULTIPLEXING: MIXING + PULLET
MULTIPROBLEM: BRILLO + METUMP
MULTISKILLED: KILLED + LITMUS
MULTIVOLTINE: MOULIN + VITTLE
MUNICIPALITY: CILIUM + PAINTY
MUSICIANSHIP: ACINUS + IMPISH
MUTAGENICITY: ACUITY + METING
MYCOPLASMATA: CLAMMY + SAPOTA
MYOINOSITOLS: LOTION + MYOSIS
MYTHOLOGIZED: GLOZED + MYTHOI
MYTHOLOGIZER: GLOOMY + ZITHER
NASALIZATION: AZONAL + ISATIN
NATURALIZING: LAZING + NUTRIA
NEUROANATOMY: OUTRAN + YEOMAN
NEWSWEEKLIES: SLINKS + WEEWEE
NIGHTCLUBBED: GLUTCH + NIBBED
NONALCOHOLIC: COLONI + LOCHAN
NONAMBIGUOUS: AUSUBO + MIGNON
NONAVAILABLE: LABIAL + NOVENA
NONBREAKABLE: ANANKE + LOBBER
NONCOLLECTOR: COLLET + CONNOR
NONCOMMITTAL: COMMON + LATTIN
NONCOMMUNITY: MUTINY + NONCOM
NONCOMPLYING: NONCOM + PLYING
NONCOMPOUNDS: NONCOM + POUNDS
NONCONFORMED: FONDER + NONCOM
NONCONGRUENT: CROTON + GUNNEN
NONEFFECTIVE: COFFEE + INVENT
NONEMOTIONAL: NONMAN + OOLITE
NONFATTENING: FINNAN + GOTTEN
NONFICTIONAL: COLONI + INFANT
NONINCLUSION: NINONS + UNCOIL
NONINFECTIVE: CONFIT + VENINE
NONLIBRARIAN: INBORN + NARIAL
NONMAMMALIAN: ALANIN + MAMMON
NONMILITANTS: TINMAN + TONSIL
NONMOTORIZED: INTRON + ZOOMED
NONNEGLIGENT: LENTEN + NOGGIN
NONOXIDIZING: DIOXIN + ZONING
NONPRODUCING: CONNOR + DUPING
NONRECURRING: CORING + RUNNER
NONRESONANTS: NONANE + SNORTS
NONSTANDARDS: DONNAS + STRAND
NONYELLOWING: LONELY + OWNING
OBJECTIFYING: IGNIFY + OBJECT
OBJECTIVISTS: OBJECT + VISITS
OBLIGATORILY: BOGART + OILILY
OFFICIALISMS: FIASCO + FILMIS
OFFICIATIONS: FIASCO + FINITO
OLIGARCHICAL: GARLIC + LOCHIA
OLIGOPHAGIES: LOGGIE + POISHA
OLIGOTROPHIC: COOLTH + PIROGI
ONCORNAVIRUS: RANCOR + VINOUS
OPPOSABILITY: BIOTAS + POLYPI
ORCHARDGRASS: AARRGH + SCRODS
ORTHOGONALLY: GANTRY + HOLLOO
ORTHORHOMBIC: COHORT + RHOMBI
ORTHOTROPOUS: POROUS + TOROTH
OUTPOLITICKS: LOCKUP + OTITIS
OUTTHROBBING: BOUTON + BRIGHT
OVERBORROWED: BORROW + OVERED
OVERCOLORING: COOLER + ROVING
OVERENROLLED: ENROLL + OVERED
OVEREVALUATE: AURATE + EVOLVE
OVEREXERCISE: CORVEE + SEXIER
OVEREXPANDED: EXPAND + OVERED
OVERFOCUSSED: DROVES + FUCOSE
OVERLENGTHEN: ELEVEN + THRONG
OVERPACKAGED: POCKED + RAVAGE
OVERTAXATION: ATONIA + VORTEX
PALEOECOLOGY: APOGEE + COOLLY
PALLIATIVELY: LEVITY + PALLIA
PANTOTHENATE: HAPTEN + NOTATE
PARADIDDLING: ALDRIN + GIDDAP
PARADROPPING: DOGNAP + RIPRAP
PARALANGUAGE: AGAPAE + LANGUR
PARFOCALIZED: FARCED + ZIPOLA
PARTICIPATOR: COTTAR + PRIAPI
PASSACAGLIAS: PASCAL + SAIGAS
PATHOLOGIZED: LAZIED + PHOTOG
PERCEPTIVELY: PELVIC + RETYPE
PERCEPTIVITY: PEPTIC + VERITY
PERFECTIVELY: FLEECY + PRIVET
PERFECTIVITY: TEPEFY + VITRIC
PETTIFOGGERY: FROGGY + PETITE
PHAGOCYTIZED: HEPCAT + ZYGOID
PHAGOCYTOTIC: COGITO + PATCHY
PHILHARMONIC: HARPIN + HOLMIC
PHILOLOGICAL: APOLOG + CHILLI
PHOSPHATIDIC: APHIDS + PHOTIC
PHOSPHATIZED: AZOTHS + HIPPED
PHOTOCOMPOSE: COMPTS + HOOPOE
PHOTOGRAPHED: HARPED + PHOTOG
PHOTOGRAPHER: HARPER + PHOTOG
PHOTOGRAVURE: GROOVE + PRUTAH
PHOTOTHERAPY: HEATHY + TROPPO
PHRAGMOPLAST: GALAHS + PROMPT
PHYCOLOGICAL: APOLOG + CHICLY
PHYCOMYCETES: CHYMES + COTYPE
PHYTOHORMONE: HOOTER + NYMPHO
PICKABACKING: BIPACK + CAKING
PILGRIMAGING: IGGING + PRIMAL
PLAGIARIZERS: ARGALI + PRIZES
PLATONICALLY: CALLAN + POLITY
PLIABILITIES: BAILIE + PISTIL
PNEUMOCOCCAL: CAPCOM + LEUCON
PODOPHYLLINS: PHYLLO + POINDS
POIKILOTHERM: KILTIE + MORPHO
POLITICALIZE: ELICIT + ZIPOLA
POLITICISING: CONGII + PISTIL
POLYEMBRYONY: BRYONY + EMPLOY
POLYGRAPHING: GLOPPY + HARING
POLYMERIZING: MOPILY + ZINGER
POLYMORPHOUS: ORMOLU + SHOPPY
POLYMYOSITIS: MYOSIS + POLITY
POLYOMAVIRUS: MOPILY + SAVOUR
POLYSYLLABIC: BALLSY + POLICY
POPULARIZING: URPING + ZIPOLA
POPULOUSNESS: POSOLE + SUNUPS
POSTHUMOUSLY: LUPOUS + MYTHOS
POSTVACCINAL: CATNIP + VOCALS
PREEXEMPTING: EXEMPT + PINGER
PREGNENOLONE: PONGEE + RONNEL
PREOCCUPANCY: OCCUPY + PRANCE
PREPUBESCENT: PECTEN + SUPERB
PREQUALIFIED: FERIAL + PIQUED
PREREQUIRING: GRIPER + REQUIN
PRESENTMENTS: PREMEN + STENTS
PRESSURIZERS: PURSER + SIZERS
PRIVATDOZENT: POTENT + VIZARD
PRIZEWINNERS: PRIZES + WINNER
PROBATIONARY: ARROBA + POINTY
PROGRAMMABLE: GAMBOL + PREARM
PROGRAMMATIC: GRAMMA + TROPIC
PROLIFICALLY: CALORY + FILLIP
PROPITIATORS: ORATOR + PIPITS
PROTOCOLLING: COLLOP + TRIGON
PSYCHOGRAPHS: GRAPHS + PSYCHO
PUFFERFISHES: FISHES + PUFFER
PUZZLEHEADED: HEADED + PUZZLE
QUADRAPHONIC: PARDON + QUAICH
QUADRIPLEGIC: GARLIC + PIQUED
QUADRUPLEXES: DUPLEX + SQUARE
QUANTIFIABLE: FUTILE + NIQAAB
QUANTITATING: GITTIN + QUANTA
QUARANTINING: GUANIN + QINTAR
QUASICRYSTAL: RACILY + SQUATS
QUINTILLIONS: INSTIL + QUINOL
QUIXOTICALLY: CLIQUY + OXTAIL
RACQUETBALLS: BURQAS + CALLET
RADICALIZING: DIAZIN + GARLIC
RADIOTHORIUM: DROUTH + MOIRAI
RAMIFICATION: FARINA + MIOTIC
RATIFICATION: FARINA + OTITIC
RECOGNIZANCE: ENCAGE + ZIRCON
RECOMMITMENT: METRIC + MOMENT
RECONQUERING: CONGER + REQUIN
RECONVINCING: CONNER + VICING
REFLECTIVITY: TERCET + VILIFY
REFRESHMENTS: ENSERF + THERMS
REHYPNOTIZED: PHYTIN + ZEROED
REINITIATING: ARTIGI + INTINE
REJUSTIFYING: IGNIFY + JUSTER
REMEMBERABLE: BEARER + EMBLEM
REMILITARIZE: LAZIER + MITIER
REMOBILIZING: RILING + ZOMBIE
REPROGRAPHER: GROPER + HARPER
RHOMBOHEDRAL: HOLARD + HOMBRE
RHYTHMICALLY: LACILY + RHYTHM
ROMANIZATION: AMAZON + ROTINI
SALPIGLOSSIS: SIGLOS + SPAILS
SALUBRIOUSLY: BLOUSY + URIALS
SANITIZATION: TATSOI + ZINNIA
SAPONIFIABLE: FOIBLE + PAISAN
SAXOPHONISTS: PHONOS + SAXIST
SCHIZOGONOUS: OZONIC + SOUGHS
SCHOOLBOYISH: BOYISH + SCHOOL
SCORNFULNESS: NELSON + SCURFS
SCREWDRIVERS: DRIVER + SCREWS
SCRIPTWRITER: SCRIPT + WRITER
SCRUPULOUSLY: OCULUS + SLURPY
SCRUTINIZERS: INCURS + RITZES
SCURRILOUSLY: COULIS + SLURRY
SELFLESSNESS: FESSES + SNELLS
SENSUOUSNESS: NONUSE + SUSSES
SEQUACIOUSLY: COULIS + QUEASY
SERVICEBERRY: REVERY + SCRIBE
SHABBINESSES: ABBESS + SHINES
SHADOWGRAPHY: PARGOS + WHYDAH
SHELLCRACKER: CRACKS + HELLER
SHEPHERDINGS: HIGHER + SPENDS
SHOWSTOPPING: HOPING + STOWPS
SHREWISHNESS: SHINES + SHREWS
SIGNIFICANCY: IGNIFY + SICCAN
SKUNKBRUSHES: BUSHER + SKUNKS
SLUGGISHNESS: GUSHES + SLINGS
SNIFFISHNESS: SHINES + SNIFFS
SNUBBINESSES: BENNIS + BUSSES
SOLMIZATIONS: MALOTI + SOZINS
SOLUBILITIES: LILIES + SUBITO
SPATCHCOCKED: PACKED + SCOTCH
SPATIALITIES: LIAISE + PITTAS
SPELLBINDING: BLENDS + PILING
SPENDTHRIFTS: SPENDS + THRIFT
SPIRITUALIST: AURIST + PISTIL
SPRIGHTFULLY: FLIGHT + SLURPY
SQUIRRELLIER: RELIER + SQUIRL
STICKLEBACKS: BASKET + CLICKS
STOCKBROKING: BROCKS + TOKING
STRINGYBARKS: BRISKS + GANTRY
SUBDISTRICTS: BRITTS + DISCUS
SUBFRAGMENTS: BUSMEN + GRAFTS
SUBINFEUDATE: INFUSE + TABUED
SUBJECTIVISE: BISECT + JUVIES
SUBJECTIVISM: CUBISM + JIVEST
SUBJUNCTIONS: BINOCS + UNJUST
SUBLANGUAGES: BAGASS + UNGLUE
SUBMAXIMALLY: BIAXAL + SLUMMY
SUBNOTEBOOKS: BETOOK + BOSUNS
SUBSIDIARITY: BRUITS + SAIYID
SUBSTANDARDS: ABSURD + STANDS
SUBURBANIZED: AZURES + DUBBIN
SUCCESSIVELY: LYCEES + VISCUS
SUFFIXATIONS: AUXINS + SOFFIT
SUGGESTIVELY: STYLUS + VEGGIE
SURVIVALISMS: MISSIS + VULVAR
SURVIVALISTS: SILVAS + VIRTUS
SYLLABICALLY: BALLSY + LACILY
SYMBOLICALLY: LACILY + SYMBOL
SYNCHRONISMS: MINORS + SYNCHS
SYNCHRONIZED: CHYRON + DIZENS
SYSTEMATIZES: TESTIS + ZYMASE
TECHNOPHOBIC: PHOBIC + TECHNO
TETANIZATION: TITIAN + ZONATE
THANKFULLEST: HATFUL + SKLENT
THEOLOGIZING: GIGOLO + ZENITH
THEORIZATION: IONIZE + THROAT
THIEVISHNESS: SHIVES + THEINS
THOROUGHBRED: BORDER + THOUGH
THOROUGHFARE: FOURTH + GHERAO
THOUSANDFOLD: FANTOD + SHOULD
THROUGHOTHER: RHETOR + THOUGH
TINSMITHINGS: SMITHS + TINING
TRACTABILITY: BRATTY + ITALIC
TRANSCRIBING: BRANTS + RICING
TRANSITIVITY: SNITTY + TRIVIA
TRIPHTHONGAL: ANTHRO + PLIGHT
TRIPLICATING: RILING + TIPCAT
TROPHOZOITES: HOTPOT + SEIZOR
TROTHPLIGHTS: PLIGHT + TROTHS
TWELVEMONTHS: MONTHS + TWELVE
TYPIFICATION: ATYPIC + FINITO
TYRANNICALLY: LACILY + TRANNY
UNAFFILIATED: AFFINE + TULADI
UNAPPEASABLE: ANABAS + PEEPUL
UNAPPEASABLY: APPEAL + BUNYAS
UNAPPETIZING: UPPING + ZEATIN
UNATTAINABLY: BANIAN + TAUTLY
UNCHANNELLED: HANDLE + NUNCLE
UNCHIVALROUS: CHINOS + UVULAR
UNCTUOUSNESS: CUSSOS + UNTUNE
UNCULTIVABLE: BULLET + VICUNA
UNDERLYINGLY: DUNLIN + GREYLY
UNDOCUMENTED: CUNDUM + DENOTE
UNEXCITINGLY: CUTELY + NIXING
UNFATHOMABLY: BOTANY + FULHAM
UNFAVOURABLY: FANBOY + UVULAR
UNFLAMBOYANT: BOTANY + MANFUL
UNFORGIVABLY: BUYING + FLAVOR
UNFRUITFULLY: FITFUL + UNRULY
UNIDENTIFIED: FINITE + INDUED
UNIFICATIONS: ACINUS + FINITO
UNITIZATIONS: OUTSIT + ZINNIA
UNLAWFULNESS: SNAFUS + UNWELL
UNLOVINGNESS: GLUONS + VENINS
UNMERCIFULLY: CYMLIN + RUEFUL
UNNEWSWORTHY: UNSEWN + WORTHY
UNPREJUDICED: JUICED + PRUNED
UNPRONOUNCED: COUPON + DUNNER
UNPROPITIOUS: INPOUR + PISTOU
UNSCRAMBLING: CRUMBS + LIGNAN
UNSCRUPULOUS: OCULUS + PRUNUS
UNSUBSCRIBES: BRUCIN + BUSSES
UNSUPPORTIVE: PIVOTS + UNPURE
VALORIZATION: TRIVIA + ZOONAL
VASECTOMIZES: COVETS + MAIZES
VAUDEVILLIAN: INLAID + VULVAE
VEGETATIVELY: GAIETY + VELVET
VELARIZATION: ATONAL + VIZIER
VENGEFULNESS: ENGULF + SEVENS
VIGINTILLION: TILING + VIOLIN
VILIFICATION: CLIVIA + FINITO
VOCALIZATION: VIATIC + ZOONAL
VOLCANOLOGIC: ALCOOL + COVING
VOLUMINOSITY: INSOUL + VOMITY
VULCANIZATES: CLAVUS + ZEATIN
WALKINGSTICK: KLICKS + TAWING
WHEELWRIGHTS: WHEELS + WRIGHT
WHIMSICALITY: ITALIC + WHIMSY
WHIPPINESSES: PEPSIN + WISHES
WHORTLEBERRY: BOLTER + WHERRY
WICKETKEEPER: KEEPER + WICKET
WITHSTANDING: ANTING + WIDTHS
WOODCUTTINGS: COUNTS + GODWIT
WORKINGWOMEN: KNOWER + MOWING
WORKMANSHIPS: MIKRON + PSHAWS
WORSHIPFULLY: FROWSY + UPHILL
XANTHOPHYLLS: HALLOT + SPHYNX
XYLOPHONISTS: POSHLY + TOXINS
ZOOLOGICALLY: LOGILY + ZOCALO
ZOOPLANKTERS: POZOLE + TRANKS
ZOOSPORANGIA: PONGOS + ZOARIA
ZWITTERIONIC: COZIER + NITWIT